#######
#     #
#  .  #
#@$   #
#  $  #
#  .  #
#######
