#######
#@ $ .#
#  $  #
#  .  #
#######